1111111111
1C00P0E001
1111111111